########
#O  PX #
#      #
# O X  #
#      #
########